NO ./pics/wall.png
SO ./pics/wall.png
WE ./pics/wall.png
EA ./pics/wall.png

F 30,15,0
C 25,40,20

       1111111
       1020201
       1010101
       1000001
       111D111
         101
         101    1111111
         101    1000001
         10111111001201
         1000000D001001
         10111111000001
         101    1111111
         101
         101
      1111D1111      111111111
      110000011111111100000001
      101E0100D000000D00020001
      110000011111111100000001
      1111D1111      111111111
         101
         101
         101
         101
       111D111
       1000001
       1011101
       101 101
       101 101
       101 101
       101 101
       101 101
      11D111D11
      100000001
      101001001
      102002001
      111111111