NO ./pics/north_texture.png
SO ./pics/south_texture.png
WE ./pics/west_texture.png
EA ./pics/east_texture.png

F 162,162,162
C 90,150,215


111111111111
1N2222222221
122222222221
122222222221
122222222221
122222222221
122222222221
111111111111
