NO  			  			
SO ./pics/wood.png
WE ./pics/greystone.png
EA ./pics/redbrick.png

F 162,162,162
C 90,150,215

11111111111111111111
11111111000001111111
10000000000000111111
10000000000000111111
10100001000010111111
10000000000000111111
10000000000000111111
10000000000000111111
10100000000010000001
10000000000000111101
10000000000000111101
10000000000000111101
10000000000000111101
10100001000010111101
10000000000000000001
11011111111110111101
11011111111110111101
11011111111110111101
11011111111110111101
11000000000000000001
11111111111111111111