NO ./pics/north_texture.png
SO ./pics/south_texture.png
WE ./pics/west_texture.png
EA ./pics/east_texture.png

F 162,162,162
C 90,150,215

11111111111111111111
11111111000001111111
10000000000000111111
10000000000000111111
10100001000010111111
10000000000000111111
1000000000000011111111111111111111111111111
1000000000000000000000000000000000000000001
10100000S0001000000000000000000000000000001
1000000000000000000000000000000000000000001
10000000D0000011110111111100011111111000001
10000000000000111101     10001      1000001
10000000000000111101     10001      1000001
10100001000010111101     10001      1000001
10000000000000000001     10001      1000001
11000000000000111101     10001      1000001
11000000000000111101     10001      1000001
11000000000000111101     10001      1000001
11000000000000111101     10001      1000001
11000000000000111101     10001      1000001
11000000000000111101     10001      1000001
11000000000000111101     10001      1000001
11000000000000111101     10001      1000001
11000000000000111101     10001      1000001
11000000000000111101     10001      1000001
11000000000000111101     10001      1000001
11000000000000111101     10001      1000001
11000000000000111101     10001      1000001
11000000000000111101     10001      1000001
11000000000000111101     10001      1000001
1100000000000011110111111100011111111000001
1100000000000000000000000000000000000000001
1100000000000000000000000000000000000000001
1100000000000000000000000000000000000000001
1111111111111111111111111111111111111111111