
NO          ./pics/eagle.png


SO                            ./pics/wood.png


WE                               ./pics/greystone.png


EA                         ./pics/redbrick.png


F                162,162,162


C                 90,150,215
       1111111
11111111000001111111111111111111111
10000000000000111101
10000000000000111101
10000000000000111101
10000000000000111101
100000000000001  101
101000010000101  101
100000000000001  101
100000000000001  101
10000000000000111101
10100000000010000001
1111111111111111111
        101
        101
        101
        101
        101
11111111101111111111
10000000000000011101
10000000000000111101
10000000000000111101
10000000000000111101
10100001000010111101111111111111111111111111111111111111111111111111111111111111
10000000000000000000000000000000000000000000000000000000000000000000000000000001
11001111111100111101111111111111111111111111111111111111111111111111111111111111
1101111   1110111101
1101111   1110111101
11011111111110111101
11000000000000000001
11111111111111111111


