NO ./pics/wall.png
SO ./pics/prison.png
WE ./pics/war.png
EA ./pics/wall.png

F 30,15,0
C 25,40,20

11111111111111111111
11111111000001111111
10000000000000111111
10000000000000111111
10100001000010111111
10000000000000111111
1000000000000011111111111111111111111111111
1000000000000000000002000000000000000000001
10100000E0021000000002000000000000000000001
1000000000000000000002000000000000000000001
100000000000001111D1111111DDD11111111000001
10000000000000111101     10001      1000001
10000000000000111101     10001      1000001
10100001000010111101     10001      1000001
10000002000000D00001     10001      1000001
11000000000000111101     10001      1000001
11000000000000111101     10001      1000001
11000000000000111101     10001      1000001
11000000000000111101     10001      1000001
11000000000000111101     10001      1000001
11000002000000111101     10001      1000001
11000021200000111101     10001      1000001
11000002000000111101     10001      1000001
11000000000000111101     10001      1000001
11000000000000111101     10001      1000001
11000000000000111101     10001      1000001
11000000000000111101     10001      1000001
11000000000000111101     10001      1000001
11000000000000111101     10001      1000001
11000000000000111101     10001      1000001
110000000000001111D1111111DDD11111111000001
1100000000000000000000D00000000000000000001
1100000000000000000000D00000000000000000001
1100000000000000000000D00000000000000000001
1111111111111111111111111111111111111111111