NO ./pics/eagle.png
SO ./pics/wood.png
WE ./pics/greystone.png
EA ./pics/redbrick.png

F 162,162,162
C 90,150,215

11111111111111111111
11111111000001111111
10000000000000111111
10000000000000111111
10100001000010111111
10000000000000111111
1000000000000011111111111111111111111111111111111111111111111111111111111111111111111111111111111111111111111111111111111111111111111111111111111111111111
1000000000000000000000000000000000000000000000000000000000000000000000000000000000000000000000000000000000000000000000000000000000000000000000000000000001
101000N000001000000000000000000000000000000000000000000000000000000000000000000000000000000000000000000000000000000000000000000000000000000000000000000001
1000000000000000000000000000000000000000000000000000000000000000000000000000000000000000000000000000000000000000000000000000000000000000000000000000000001
1000000000000011110111111111111111111111111111111111111111111111111111111111111111100011111111111111111111111111111111111111111111111111111111111111000001
10000000000000111101                                                              10001                                                            1000001
10000000000000111101                                                              10001                                                            1000001
10100001000010111101                                                              10001                                                            1000001
10000000000000000001                                                              10001                                                            1000001
11000000000000111101                                                              10001                                                            1000001
11000000000000111101                                                              10001                                                            1000001
11000000000000111101                                                              10001                                                            1000001
11000000000000111101                                                              10001                                                            1000001
11000000000000111101                                                              10001                                                            1000001
11000000000000111101                                                              10001                                                            1000001
11000000000000111101                                                              10001                                                            1000001
11000000000000111101                                                              10001                                                            1000001
11000000000000111101                                                              10001                                                            1000001
11000000000000111101                                                              10001                                                            1000001
11000000000000111101                                                              10001                                                            1000001
11000000000000111101                                                              10001                                                            1000001
11000000000000111101                                                              10001                                                            1000001
11000000000000111101                                                              10001                                                            1000001
11000000000000111101                                                              10001                                                            1000001
1100000000000011110111111111111111111111111111111111111111111111111111111111111111100011111111111111111111111111111111111111111111111111111111111111000001
1100000000000000000000000000000000000000000000000000000000000000000000000000000000000000000000000000000000000000000000000000000000000000000000000000000001
1100000000000000000000000000000000000000000000000000000000000000000000000000000000000000000000000000000000000000000000000000000000000000000000000000000001
110N000000000000000000000000000000000000000000000000000000000000000000000000000000000000000000000000000000000000000000000000000000000000000000000000000001
1111111111111111111111111111111111111111111111111111111111111111111111111111111111111111111111111111111111111111111111111111111111111111111111111111111111
