NO ./pics/north_texture.png
SO ./pics/south_texture.png
WE ./pics/west_texture.png
EA ./pics/east_texture.png

F 162,162,162
C 90,150,215

111111111111111111
111  111000001111111
10111100011100000001
1000000N000000100001
10101001000010001001
10000000000000000001
11111111111111111111
