NO          ./path_to_the_north_texture
SO            ./path_to_the_south_texture
WE           ./path_to_the_west_texture
EA        ./path_to_the_east_texture


F      162,162,162
C        90,150,215

     111111111
111111110000011111111111
10000000000000111111
10000000000000111111
10100001000010111111
10000000000000111111
10000000000000111111
10000000000000111111
10100000000010000001
10000000000000111101
10000000000000111101
10000000000000111101
10000000000000111101
101000010000101111011111111111
100000000000000000000000000001
110111111111101111011111111111
1101111   1110111101
1101111   1110111101
11011111111110111101
11000000000000000001
11111111111111111111