NO ./path
WE ./path
EA ./path
SO ./path
F ./path
C ./path

11111111111
    101101111
1111100001
1000000001
10000000011
11111111111